%%%%%%%%
%P.....%
%..%...%
%..%...%
%..%...%
%.....G%
%%%%%%%%
