%%%%%%%
%P    %
% %%% %
% %   %
% %%% %
%.    %
%%%%%%%
