%%%%%%%
%P    %
% %%% %
% %   %
% %%% %
%.    %
%%%%%%%
%%%%%%%
%P   .%
% %%% %
% %   %
% %%% %
%     %
%%%%%%%
