%%%%%%%
%.P...%
%.%%%.%
%.%...%
%.%%%.%
%.....%
%%%%%%%
