%%%%%%%
%P   .%
% %%% %
% %   %
% %%% %
%     %
%%%%%%%
