%%%%%%%
%.P...%
%.% %.%
%.   .%
%.% %.%
%..G..%
%%%%%%%
